1111111111111
10010C01C0001
10C0011111001
100011E0000P1
1111111111111