111111111111111111111111111
1C0000000000000000000000001
100111111111100111111111001
100111111111100111111111001
1P00000000000000000000000E1
100111111111100111111111001
100111111111100111111111001
100000000000000000000000001
111111111111111111111111111