1111111111111111
1000000000000001
1001111111111001
1001111111111001
1000000000000C01
1000000000000001
1001111001111001
1001111001111001
1P00000000000001
1000000000000001
1001111001111001
1001111001111001
1000000000000001
1E00000000000001
1001111001111001
1001111001111001
1000000C00000001
1111111111111111