111111111111111111111111111111111111111111111
1E0000000000000000C00000000000000000000000001
101001010010000010100100000001010011111111111
101001001010101000100100000001010100000000001
1P0000000000000000000000000000000011111111111
111111111111111111111111111111111111111111111