111111111111111
100100000000001
10000111110C011
1P0011E00000001
100010000000011
111111111111111