111111111111111
1CC1CCCCCCCCCC1
1CCCC11111CCC11
1PCC11ECC1CCCC1
1CCC1CCCCCCCC11
1CCC1CCCCCCCC11
1CCC1CCCCCCCC11
1CCC1CCCCCCCC11
1CCC1CCCC0CCC11
1CCC1CCC111CC11
1CCC1CCC111CC11
111111111111111