111111111111111
1CC1CCCCCCCCCC1
1CCCC11111CCC11
1PCC11ECC1CCCC1
1CCC1CCCCCCCC11
1CCC1CCCCCCCC11
1CCC10000CCCC11
1CCC10000CCCC11
1CCC1000000CC11
1CCC1CCC111CC11
1CCC1CCC1110C11
111111111111111