111111111111111
1CC111111111111
1CCCCCCCCCC0C11
1CCC1111111CCC1
1CCC1111111C111
11CC11CCC11C111
11CC11CCC11CC11
11CC11CCC11CC11
11C11CCCCCCC111
11CC11CC111CC11
1CCC11CC11PCE11
111111111111111