111111111111111111111111111111111111111
1P0000000000000000000000000000011111111
101001010010000010100000001010011111111
101001001010101000100000001010100000001
1E000000000000000C000000000000000000001
111111111111111111111111111111111111111