111111111111111111111111111
1E0000000000C000000000000C1
101110001110001110001110001
101110001110001110001110001
101110001110001110001110001
100000000000000000000000001
101110001110001110001110001
101110001110001110001110001
101110001110001110001110001
100000000000000000000000001
101110001110001110001110001
101110001110001110001110001
101110001110001110001110001
1P0000000000000000000000001
111111111111111111111111111